0000000000010000000000000000000100000000
1111110111111111111100000000000100000000
0010010100001000000000000000000100000000
0000000000001010000000000000000100000000
1111111111101111111100000000000100000000
0000000000101000000000000000000100000000
0000000000101000100000000000000100000000
0111100000100000000000000000000100000000
0000000000100000000000000000000100000000
0000000000101111111100000000000100000000
0001000000100001000000000000000100000000
0000000000100111111100000000000100000000
0000000000100000000000000000000100000000
0000000000111111111100000000000100000000
0000000000010000000000000000000100000000
1111110111111111111100000000000100000000
0010010100001000000000000000000100000000
0000000000001010000000000000000100000000
1111111111101111111100000000000100000000
0000000000101000000000000000000100000000
0000000000101000100000000000000100000000
0111100000100000000000000000000100000000
0000000000100000000000000000000100000000
0000000000101111111100000000000100000000
0001000000100001000000000000000100000000
0000000000100111111100000000000100000000
0000000000100000000000000000000100000000
0000000000111111111100000000000100000000
