1111111111111111111111111111111111111111
1000000000000000000000000000000000000001
1000000000000000000000000000000000000001
1000000000000000000000000000000000000001
1000000000000000000000000000000000000001
1000000000000000000000000000000000000001
1000000000000000000000000000000000000001
1000000000011111100000111000000000000001
1000000000010000110011101110000000000001
1000000000100000011110000011000000000001
1000000000100000001100000001000000000001
1000000000100000000000000001000000000001
1000000000100000000000000001000000000001
1000000000100000000000000001000000000001
1000000000110000000000000001000000000001
1000000000010000000000000011000000000001
1000000000001000000000001110000000000001
1000000000000100000000011000000000000001
1000000000000011000011100000000000000001
1000000000000001110110000000000000000001
1000000000000000011100000000000000000001
1000000000000000000000000000000000000001
1000000000000000000000000000000000000001
1000000000000000000000000000000000000001
1000000000000000000000000000000000000001
1000000000000000000000000000000000000001
1000000000000000000000000000000000000001
1000000000000000000000000000000000000001
1000000000000000000000000000000000000001
1111111111111111111111111111111111111111
