00000000001000000000
00000000001000000000
00000000000000000000
00000000000000000000
00001100000000100000
00001000000000000000
00000100000000000000
00000100000001100000
00000100000010000000
00000111111100000000
00000000000000000000
00000000000000000000
00000000000000000000
00000000000000000000
00000000000000000000
